farsi is An Male Voice For Mbrola Synthesizer.
Mbrola Diphone DataBase Provided By Iranian Communication Industry Research Group.
It Cosists of 1300 Diphones.

Contact: Alireza Farhadi
Email: leadstar2k@yahoo.com


p	sup
b	xub
t	sut
d	dud
c	pa:c
g:	sang:
k	ka:r
g	gorbe
q	qand
?	mans:a?
s	pas
z	hefz
s:	s:ur
z:	z:ulide
f	fil
v	vorud
x	xorma
h	hava:
c:	c:era:
j:	j:ura:b
r	ros:d
m	matni
n	na:n
l	lab
y	ya:d
i	ces:ti
e	se
a	va
u	ja:ru
o	mapors
a:	ba:ba:
a:y	c:a:y
uy	muy
oy	xoy
ay	s:ay
ey	dey
ow	dow
